1111111
10P0001
10C0101
1110101
1C001E1
1111111