1111111111111111111111111
100C0010000100000000000C1
1E1110C010000001111111101
101111111111111100C001101
1P0000000C0000000110000C1
1111111111111111111111111